#.......4!
#.........
#.....a...
#...bba...
#cc..dee..
##.ffd..gg
^A......B^
###>#...##
