####2aaA##
...B.^CC..
!4.^..CC..
...D.^.*..
######....
########>#

