#####>#######
####...3#####
.aab...4#####
....Acc!#####
.###ddee#####
*#####[.....#
.#####.#.B..#
]#####......#
