.*..^#
5....#
!4aaA>
##aa##
##..##
##..##
#B..C#
#....#
