#*!...A2
#5....^.
#...aa..
Bbcc..##
Cbcc.*##
......##
###>####
