#....2#
#.AA..#
.BAA..#
#5CC^.>
#.CC..#
#DEE..#
#FEE4!#


