######!#####
######4#####
#>####5#####
ABB###2#aa.C
.BB###.#aa.b
............
..*###.#####
######D#####
