#.......
>.A.!.[.
#.......
########
#...####
..].####
2...####
