##>##
a43!b
A....
#...#
#...#
#.B.#
#...#
