##>###
*..*.*
.!5...
....a.
##bc##
##dA##
##B3##
