###>####
.......A
!..2....
#....#..
##...#..
###.....
####..B.
