####.*...
####.*..A
####.....
....*^#..
.!...^#..
#######.2
#######..
#######>#
