#####>####
....A.....
.2..!...#.
#.........
...B...*.#
.C..D.....
....^.....
....E..^^^
