####>######
###.......#
###...aab.#
###...c4b.#
^A....c!...
###.......#
