...^....
...A*...
.......*
.*.....*
...B.C..
#....^..
#>##DDE.
####DD..
####!4..
