##.#####
##.##>##
^A..a...
....a...
##bb....
##......
##.!4...
