###A####
.......#
.A.2.A.#
...*...#
......!#
^.....3>
##A#A###
