#....A...#
#...3....#
#..*..*B.#
#!..##a..C
>...##a..D
#..*..*..#
#.E..2...#
#...F....#

